11111111111111111111111111111111111111112222222222222222222222222222222222222222222222222222222222222222222222222222
11111111111111111111111111111111111111112222222222222222222222222222222222222222222222222222222222222222222222222222
11111111111111111111111111111111111111112222222222222222222222222222222222222222222222222222222222222222222222222222
11111111111111111111111111111111111111112222222222222222222222222222222222222222222222222222222222222222222222222222
11111111111111111111111111111111111111112222222222222222222222222222222222222222222222222222222222222222222222222222
11111111111111111111111111111111111111112222222222222222222222222222222222222222222222222222222222222222222222222222
11111111111111111111111111111111111111112222222222222222222222222222222222222222222222222222222222222222222222222222
11111111111111111111111111111111111111112222222222222222222222222222222222222222222222222222222222222222222222222222
11111111111111111111111111111111111111112222222222222222222222222222222222222222222222222222222222222222222222222222
11111111111111111111111111111111111111112222222222222222222222222222222222222222222222222222222222222222222222222222
11111111111111111111111111111111111111112222222222222222222222222222222222222222222222222222222222222222222222222222
11111111111111111111111111111111111111112222222222222222222222222222222222222222222222222222222222222222222222222222
11111111111111111111111111111111111111112222222222222222222222222222222222222222222222222222222222222222222222222222
11111111111111111111111111111111111111112222222222222222222222222222222222222222222222222222222222222222222222222222
11111111111111111111111111111111111111112222222222222222222222222222222222222222222222222222222222222222222222222222
11111111111111111111111111111111111111112222222222222222222222222222222222222222222222222222222222222222222222222222
11111111111111111111111111111111111111112222222222222222222222222222222222222222222222222222222222222222222222222222
11111111111111111111111111111111111111112222222222222222222222222222222222222222222222222222222222222222222222222222
11111111111111111111111111111111111111112222222222222222222222222222222222222222222222222222222222222222222222222222
11111111111111111111111111111111111111112222222222222222222222222222222222222222222222222222222222222222222222222222
11111111111111111111111111111111111111112222222222222222222222222222222222222222222222222222222222222222222222222222
11111111111111111111111111111111111111112222222222222222222222222222222222222222222222222222222222222222222222222222
11111111111111111111111111111111111111112222222222222222222222222222222222222222222222222222222222222222222222222222
11111111111111111111111111111111111111112222222222222222222222222222222222222222222222222222222222222222222222222222
11111111111111111111111111111111111111112222222222222222222222222222222222222222222222222222222222222222222222222222
11111111111111111111111111111111111111112222222222222222222222222222222222222222222220000000002222222222222222222222
11111111111111111111111111111111111111112222222222222222222222222222222222222222222220000000002222222222222222222222
00000000000000000000000000000000000000000000000000000000000000000000000000000000000000000000000000000000000000000000
00000000000000000000000000000000000000000000000000000000000000000000000000000000000000000000000000000000000000000000
00000000000000000000000000000000000000000000000000000000000000000000000000000000000000000000000000000000000000000000
